#############.A
.#######.#...G.
.##...#...##s.#
###.#...#.#....
###.##.#....##.
###..e######...
.###..#...###..
#####...#...#..
##....#####...#
##.#.#####w#.##
##.l##...##..##
.##.#..#....###
..#.#...####
.D##...##..####